0,0,0,0,0,0,0,0,0,0,0,0,0,0,0,0,3,0,0,4,4,4,3,3,3,4,4,4,4,3,3,1,1
0,0,0,0,0,0,0,0,0,0,0,0,0,0,0,0,3,0,0,4,4,4,4,4,4,4,3,4,4,3,3,3,1
0,0,0,0,0,0,0,0,0,0,0,0,0,0,0,0,4,0,0,4,4,4,4,4,4,3,3,4,4,3,3,3,3
0,0,0,0,0,0,0,0,0,0,0,0,0,0,0,0,3,0,0,4,4,3,4,3,4,3,3,4,3,3,3,3,3
0,0,0,0,0,0,0,0,7,0,7,0,0,3,3,0,3,0,0,3,3,3,3,3,4,3,3,4,4,3,4,3,3
0,0,0,7,7,7,1,7,7,7,7,0,0,3,3,3,3,3,0,3,3,3,3,3,4,3,3,4,4,4,4,3,3
7,7,7,7,7,3,7,7,7,4,4,4,4,4,1,1,4,1,1,3,3,4,4,3,4,4,3,4,4,4,4,3,4
0,7,4,7,3,3,7,7,4,4,4,7,4,4,4,4,3,1,1,3,3,3,3,4,3,4,4,7,4,4,3,4,4
0,0,4,7,7,7,7,7,4,3,4,3,3,3,4,3,3,1,1,3,3,3,3,3,3,4,4,3,3,3,4,4,4
0,0,0,7,7,7,7,7,4,4,4,4,4,4,3,4,4,3,3,1,4,4,3,1,3,3,4,3,4,3,4,3,4
0,0,0,4,7,7,7,7,7,4,4,4,4,4,4,4,4,3,3,1,4,3,3,3,1,3,4,3,4,3,3,4,3
0,0,0,4,4,4,7,7,7,7,4,3,3,4,4,4,4,4,3,1,3,3,4,1,4,4,3,3,3,3,3,4,4
0,0,0,4,4,3,4,7,7,7,7,7,4,4,3,4,4,3,3,3,3,4,3,4,4,4,3,4,3,4,3,4,3
0,0,0,4,7,4,4,4,7,7,7,7,1,7,3,3,4,4,3,7,7,3,1,1,3,3,1,3,3,3,4,4,4
0,0,0,0,4,4,4,3,3,4,4,7,7,7,7,3,3,3,4,4,7,3,1,1,1,1,1,3,3,3,4,4,3
0,0,0,0,4,4,4,4,4,3,4,4,4,3,1,1,4,4,4,4,3,3,4,4,4,1,1,1,1,1,1,3,3
0,0,0,0,0,4,4,4,4,4,3,3,3,3,1,1,1,1,3,1,4,3,4,4,4,3,3,1,1,7,7,3,4
0,0,0,0,0,4,4,4,4,4,3,3,3,3,4,1,1,1,1,4,4,3,4,4,3,4,3,1,1,1,1,1,7
0,0,0,0,0,0,4,4,4,4,4,4,3,3,3,3,1,1,3,4,3,4,3,4,3,3,3,3,3,3,1,1,3
0,0,0,0,0,0,0,4,4,4,4,4,3,3,4,3,1,3,3,4,3,4,3,4,3,3,3,3,3,3,3,3,4
0,0,0,0,0,0,0,0,0,0,4,4,3,3,4,1,1,3,4,4,3,4,3,3,4,3,4,4,3,4,4,4,3
0,0,0,0,0,0,0,0,0,4,4,4,3,3,3,1,1,3,3,3,3,4,3,3,3,3,4,4,4,3,3,4,3
0,0,0,0,0,0,0,0,0,4,4,3,3,3,3,1,1,3,3,3,3,4,3,4,3,3,3,4,3,3,3,4,4
0,0,0,0,0,0,0,0,0,4,4,3,3,3,3,1,1,3,3,3,3,3,3,3,3,3,3,4,3,3,3,3,4
0,0,0,0,0,0,0,0,0,3,4,4,4,3,3,1,1,1,3,3,3,3,3,4,3,3,3,4,4,3,4,4,4
0,0,0,0,0,0,0,0,0,3,3,4,4,3,3,3,1,1,3,3,4,3,3,4,3,3,3,4,4,3,3,4,3